语音室
0488|格物805
0489|格物810
0490|2001
0491|2003
0492|2006
0493|2007
0494|2008
0495|2015
0496|3006
0497|3007
